R 1920 1080
NO ./texture/wall_n.xpm
SO ./texture/wall_n.xpm
WE ./texture/wall_n.xpm
EA ./texture/wall_n.xpm
S ./texture/wall_n.xpm

F 204,204,153
C 000,051,204

        1111111111111111111111111
        1000000000110000000000001
        1011000001110000002000001
        1001000000000000000000001
111111111011000001110000000000001
100000000011000001110111111111111
11110111111111011100000010001
11110111111111011101010010001
11000000110101011100000010001
10002000000000001100000010001
10000000000000001101010010001
1100000111010101111101111000111
1111N111 1110101 101111010001
11111111 1111111 111111111111